1	9	366	56	10	30
1	9	266	56	11	1
1	573	216	57	11	1
1	573	415	57	11	32
1	609	178	19	37	1
1	589	178	19	37	1
1	569	178	19	37	1
1	549	178	19	37	1
1	529	178	19	37	1
1	509	178	19	37	1
1	489	178	19	37	1
1	469	178	19	37	1
1	449	178	19	37	1
1	429	178	19	37	1
1	409	178	19	37	1
1	389	178	19	37	1
1	369	178	19	37	1
1	349	178	19	37	1
1	329	178	19	37	1
1	309	178	19	37	1
1	289	178	19	37	1
1	269	178	19	37	1
1	249	178	19	37	1
1	229	178	19	37	1
1	209	178	19	37	1
1	189	178	19	37	1
1	169	178	19	37	1
1	149	178	19	37	1
1	129	178	19	37	1
1	109	178	19	37	1
1	89	178	19	37	1
1	69	178	19	37	1
1	9	228	19	37	4
1	29	228	19	37	1
1	49	228	19	37	1
1	69	228	19	37	1
1	89	228	19	37	1
1	109	228	19	37	1
1	129	228	19	37	1
1	169	228	19	37	1
1	149	228	19	37	1
1	189	228	19	37	1
1	209	228	19	37	1
1	229	228	19	37	1
1	249	228	19	37	1
1	269	228	19	37	1
1	289	228	19	37	1
1	309	228	19	37	1
1	329	228	19	37	1
1	349	228	19	37	1
1	369	228	19	37	1
1	389	228	19	37	1
1	409	228	19	37	1
1	429	228	19	37	1
1	449	228	19	37	1
1	469	228	19	37	1
1	489	228	19	37	1
1	509	228	19	37	1
1	529	228	19	37	1
1	549	228	19	37	1
1	569	228	19	37	1
1	589	228	19	37	1
1	609	228	19	37	1
1	609	278	19	37	1
1	549	278	19	37	1
1	529	278	19	37	1
1	509	278	19	37	1
1	489	278	19	37	1
1	469	278	19	37	1
1	449	278	19	37	1
1	429	278	19	37	1
1	409	278	19	37	1
1	389	278	19	37	1
1	369	278	19	37	1
1	349	278	19	37	1
1	329	278	19	37	1
1	309	278	19	37	1
1	289	278	19	37	1
1	269	278	19	37	1
1	249	278	19	37	1
1	229	278	19	37	1
1	209	278	19	37	1
1	189	278	19	37	1
1	169	278	19	37	1
1	149	278	19	37	1
1	129	278	19	37	1
1	109	278	19	37	1
1	89	278	19	37	1
1	69	278	19	37	1
1	49	278	19	37	1
1	29	278	19	37	1
1	9	278	19	37	1
1	9	328	19	37	9
1	29	328	19	37	1
1	49	328	19	37	1
1	69	328	19	37	1
1	89	328	19	37	1
1	109	328	19	37	1
1	129	328	19	37	1
1	149	328	19	37	1
1	169	328	19	37	1
1	189	328	19	37	1
1	209	328	19	37	1
1	229	328	19	37	1
1	249	328	19	37	1
1	269	328	19	37	1
1	289	328	19	37	1
1	309	328	19	37	1
1	329	328	19	37	1
1	349	328	19	37	1
1	369	328	19	37	1
1	389	328	19	37	1
1	409	328	19	37	1
1	429	328	19	37	1
1	449	328	19	37	1
1	469	328	19	37	1
1	489	328	19	37	1
1	509	328	19	37	1
1	529	328	19	37	1
1	549	328	19	37	1
1	569	328	19	37	1
1	589	328	19	37	1
1	609	328	19	37	1
1	449	377	19	37	36
1	429	377	19	37	11
1	409	377	19	37	9
1	389	377	19	37	9
1	369	377	19	37	9
1	349	377	19	37	107
1	229	377	19	37	1
1	209	377	19	37	1
1	189	377	19	37	6
1	169	377	19	37	21
1	149	377	19	37	5
1	129	377	19	37	5
1	109	377	19	37	5
1	89	377	19	37	4
1	69	377	19	37	5
1	49	377	19	37	4
1	29	377	19	37	3
1	9	377	19	37	2
1	609	377	19	37	1
1	589	377	19	37	1
1	569	377	19	37	10
1	549	377	19	37	9
1	529	377	19	37	9
1	509	377	19	37	10
1	489	377	19	37	10
1	469	377	19	37	9
2	67	166	140	9	1
2	208	166	140	9	1
2	349	166	140	9	1
2	490	166	140	9	1
2	490	266	140	9	1
2	349	266	140	9	1
2	208	266	140	9	1
2	67	266	140	9	1
2	67	366	140	9	1
2	208	366	140	9	1
2	349	366	140	9	1
2	490	366	140	9	1
2	9	416	140	9	2
2	150	416	140	9	1
2	291	416	140	9	1
2	432	416	140	9	1
2	432	316	140	9	1
2	291	316	140	9	1
2	150	316	140	9	1
2	9	316	140	9	2
2	9	216	140	9	1
2	150	216	140	9	1
2	291	216	140	9	1
2	432	216	140	9	1
2	9	100	84	9	1
2	181	100	89	9	1
2	361	100	89	9	1
2	541	100	89	9	1
1	249	376	19	39	9
1	269	376	19	39	9
1	289	376	19	39	8
1	309	376	19	39	8
1	329	376	19	39	8
1	574	316	56	10	30
1	569	277	19	37	10
1	589	277	19	37	10
