1	550	104	8	7	4
1	78	104	8	7	6
1	71	112	23	7	4
1	543	112	23	7	6
1	536	120	36	7	4
1	64	120	36	7	2
1	57	128	48	7	1
1	530	128	48	7	6
1	524	136	59	7	3
1	52	136	59	7	3
1	63	144	37	7	3
1	535	144	37	7	3
1	542	152	23	7	3
1	70	152	23	7	3
2	77	160	7	47	1
2	549	160	7	47	1
1	149	270	19	9	1
1	129	260	19	9	1
1	129	250	19	9	1
1	149	210	19	9	1
1	129	220	19	9	1
1	129	230	19	9	1
1	409	280	19	9	1
1	429	270	19	9	1
1	429	260	19	9	1
1	449	250	19	9	1
1	409	200	19	9	1
1	429	210	19	9	1
1	429	220	19	9	1
1	449	230	19	9	1
1	269	260	19	9	1
1	289	250	19	9	1
1	269	250	19	9	1
1	249	250	19	9	1
1	249	220	19	9	1
1	289	220	19	9	1
1	269	210	19	9	1
1	269	220	19	9	1
2	129	240	19	9	1
2	249	320	19	9	1
2	229	340	19	9	1
2	249	330	19	9	1
2	249	340	19	9	1
2	249	350	19	9	1
2	249	360	19	9	1
2	349	360	19	9	1
2	349	320	19	9	1
2	349	330	19	9	1
2	349	340	19	9	1
2	269	340	19	9	1
2	369	340	19	9	1
2	349	350	19	9	1
2	329	340	19	9	1
1	389	340	19	9	1
1	369	330	19	9	1
1	369	300	19	9	1
1	349	310	19	9	1
1	329	320	19	9	1
1	309	350	19	9	1
1	289	340	19	9	1
1	269	330	19	9	1
1	269	310	19	9	1
1	229	330	19	9	1
1	189	350	19	9	1
1	209	350	19	9	1
1	229	350	19	9	1
1	273	170	34	9	1
1	253	170	19	9	1
1	213	130	19	9	1
1	233	150	19	9	1
1	308	170	19	9	2
1	328	150	19	9	1
1	348	130	19	9	1
1	318	160	19	9	1
1	338	140	19	9	1
1	358	120	19	9	1
1	243	160	19	9	1
1	223	140	19	9	1
1	203	120	19	9	1
2	283	150	19	9	1
2	272	140	19	9	1
2	292	140	19	9	1
2	301	130	19	9	1
2	281	130	19	9	1
2	261	130	19	9	1
2	310	120	19	9	1
2	290	120	19	9	1
2	270	120	19	9	1
2	250	120	19	9	1
1	86	460	19	9	1
1	106	460	19	9	1
1	126	460	19	9	1
1	126	420	19	9	1
1	106	420	19	9	1
1	86	420	19	9	1
1	66	420	19	9	1
1	86	400	19	9	1
1	106	400	19	9	1
1	126	380	19	9	1
1	136	450	19	9	1
1	116	450	19	9	1
1	96	450	19	9	1
1	96	430	19	9	1
1	116	430	19	9	1
1	96	390	19	9	1
1	116	390	19	9	1
1	496	460	19	9	1
1	516	460	19	9	1
1	536	460	19	9	1
1	556	440	19	9	1
1	536	440	19	9	1
1	496	440	19	9	1
1	476	420	19	9	1
2	496	420	19	9	1
1	516	440	19	9	1
2	516	420	19	9	1
1	536	420	19	9	1
1	556	420	19	9	1
1	396	400	19	9	1
1	516	400	19	9	1
1	96	360	19	9	1
1	76	360	19	9	1
1	56	340	19	9	1
2	96	340	19	9	1
2	116	340	19	9	1
2	136	340	19	9	1
2	136	320	19	9	1
2	116	320	19	9	1
1	76	320	19	9	1
1	96	320	19	9	1
1	86	330	19	9	1
1	66	330	19	9	1
2	106	330	19	9	1
2	126	330	19	9	1
1	146	330	19	9	1
1	86	350	19	9	1
1	106	350	19	9	1
1	126	350	19	9	1
1	486	390	19	9	1
1	506	390	19	9	1
1	526	390	19	9	1
1	526	410	19	9	1
1	546	410	19	9	1
1	486	410	19	9	1
1	466	410	19	9	1
1	486	430	19	9	1
2	506	410	19	9	1
1	446	390	19	9	1
1	426	390	19	9	1
1	446	370	19	9	1
1	426	370	19	9	1
1	435	380	19	9	1
1	415	380	19	9	1
1	435	360	19	9	1
1	395	390	19	9	1
1	435	410	19	9	1
1	395	410	19	9	1
1	415	420	19	9	1
1	435	430	19	9	1
1	455	430	19	9	1
2	506	430	19	9	1
1	526	430	19	9	1
1	229	230	99	9	5
1	148	370	99	9	1
1	476	380	99	9	4
1	416	400	99	9	4
1	56	410	79	9	4
1	86	440	79	9	3
1	86	310	79	9	5
2	149	240	79	9	2
2	229	240	79	9	1
2	309	240	79	9	1
2	389	240	79	9	1
