2	287	269	32	32	1
2	96	203	32	32	1
2	55	203	32	32	1
2	512	203	32	32	1
2	553	203	32	32	1
1	287	302	32	32	1
1	320	335	32	32	1
1	287	335	32	32	1
1	254	335	32	32	1
1	221	368	32	32	1
1	221	401	32	32	1
1	221	434	32	32	1
1	353	434	32	32	1
1	353	401	32	32	1
1	353	368	32	32	1
2	353	335	32	32	1
2	320	302	32	32	1
2	254	302	32	32	1
2	221	335	32	32	1
2	594	203	33	32	1
1	485	170	32	32	1
1	518	170	32	32	1
1	551	170	32	32	1
1	584	170	32	32	1
1	452	170	32	32	1
1	419	170	32	32	1
1	386	170	32	32	1
1	320	170	32	32	1
1	353	170	32	32	1
2	155	368	32	32	1
2	155	401	32	32	1
2	155	434	32	32	1
2	419	434	32	32	1
2	419	401	32	32	1
2	419	368	32	32	1
1	386	335	32	32	1
1	419	335	32	32	1
1	452	335	32	32	1
1	188	335	32	32	1
1	155	335	32	32	1
1	122	335	32	32	1
1	485	335	32	32	1
1	518	335	32	32	1
1	551	335	32	32	1
1	584	335	32	32	1
1	89	335	32	32	1
1	56	335	32	32	1
1	23	335	32	32	1
2	287	203	32	32	1
2	287	170	32	32	1
2	287	137	32	32	1
2	254	137	32	32	1
2	320	137	32	32	1
1	89	104	32	32	1
1	122	104	32	32	1
1	155	104	32	32	1
1	188	104	32	32	1
1	221	104	32	32	1
1	254	104	32	32	1
1	320	104	32	32	1
1	353	104	32	32	1
1	386	104	32	32	1
1	419	104	32	32	1
1	452	104	32	32	1
1	485	104	32	32	1
1	518	104	32	32	1
1	122	71	32	32	1
1	155	71	32	32	1
1	188	71	32	32	1
1	419	71	32	32	1
1	452	71	32	32	1
1	485	71	32	32	1
1	452	203	32	32	1
1	452	236	32	32	1
1	452	269	32	32	2
1	485	269	32	32	1
1	518	269	32	32	1
1	419	236	32	32	1
1	386	236	32	32	1
1	188	203	32	32	1
1	188	236	32	32	1
1	221	236	32	32	1
1	155	269	32	32	1
1	122	269	32	32	1
1	89	269	32	32	1
1	254	170	32	32	1
1	221	170	32	32	1
1	188	170	32	32	1
1	155	170	32	32	1
1	122	170	32	32	1
1	89	170	32	32	1
1	56	170	32	32	1
1	23	170	32	32	1
2	14	203	32	32	1
