1	409	430	19	9	60
1	409	460	19	9	19
1	409	450	19	9	1
1	409	440	19	9	12
1	209	340	19	9	1
1	229	350	19	9	1
1	229	340	19	9	1
1	369	340	19	9	1
1	349	340	19	9	1
1	349	350	19	9	1
1	329	420	19	9	1
1	249	420	19	9	1
1	269	420	19	9	1
1	309	420	19	9	1
2	289	210	19	9	1
2	289	220	19	9	1
2	289	230	19	9	1
2	289	240	19	9	1
2	269	240	19	9	1
2	309	240	19	9	1
2	309	200	19	9	1
2	309	190	19	9	1
2	329	190	19	9	1
2	329	200	19	9	1
2	269	200	19	9	1
2	249	200	19	9	1
2	249	190	19	9	1
2	269	190	19	9	2
2	269	180	19	9	1
2	249	180	19	9	1
2	329	180	19	9	1
2	309	180	19	9	1
1	229	180	19	9	1
1	229	190	19	9	1
1	229	200	19	9	1
1	229	210	19	9	1
1	229	220	19	9	1
1	229	230	19	9	1
1	229	240	19	9	1
1	229	250	19	9	1
1	229	260	19	9	2
1	229	270	19	9	1
1	249	270	19	9	1
1	269	270	19	9	1
1	289	270	19	9	1
1	309	270	19	9	1
1	329	270	19	9	1
1	349	180	19	9	1
1	349	190	19	9	1
1	349	200	19	9	1
1	349	210	19	9	1
1	349	220	19	9	1
1	349	230	19	9	1
1	349	240	19	9	1
1	349	250	19	9	1
1	349	260	19	9	1
1	349	270	19	9	1
1	329	260	19	9	1
1	329	250	19	9	1
1	329	240	19	9	1
1	329	230	19	9	1
1	329	220	19	9	1
1	329	210	19	9	1
1	309	210	19	9	1
1	309	230	19	9	1
1	309	220	19	9	1
1	269	210	19	9	1
1	269	220	19	9	1
1	269	230	19	9	1
1	249	230	19	9	1
1	249	220	19	9	1
1	249	210	19	9	1
1	249	240	19	9	1
1	249	250	19	9	1
1	249	260	19	9	1
2	269	250	19	9	1
2	269	260	19	9	1
2	289	260	19	9	2
2	309	260	19	9	1
2	309	250	19	9	1
2	289	250	19	9	1
2	289	170	19	9	1
2	269	160	19	9	1
2	249	160	19	9	1
2	229	150	19	9	1
2	309	160	19	9	1
2	329	160	19	9	1
2	349	150	19	9	1
1	349	170	19	9	1
1	329	170	19	9	1
1	309	170	19	9	1
1	289	180	19	9	1
1	289	190	19	9	1
1	289	200	19	9	1
1	249	170	19	9	1
1	269	170	19	9	1
1	229	170	19	9	1
1	229	160	19	9	1
1	349	160	19	9	1
1	329	150	19	9	1
1	309	150	19	9	1
1	289	150	19	9	1
1	289	160	19	9	1
1	269	150	19	9	1
1	249	150	19	9	1
1	269	140	19	9	1
1	289	140	19	9	1
1	309	140	19	9	1
1	289	130	19	9	1
1	289	280	19	9	1
1	269	280	19	9	1
1	309	280	19	9	1
1	309	290	19	9	1
1	309	300	19	9	1
1	289	310	19	9	1
1	289	300	19	9	1
1	289	290	19	9	1
1	269	290	19	9	1
1	269	300	19	9	1
2	269	320	19	9	1
2	289	320	19	9	1
2	309	310	19	9	1
2	269	310	19	9	1
2	309	320	19	9	1
2	309	330	19	9	1
2	309	340	19	9	1
2	309	350	19	9	1
2	309	360	19	9	1
2	309	370	19	9	1
2	309	380	19	9	1
2	309	390	19	9	1
2	309	400	19	9	1
2	309	410	19	9	1
2	269	410	19	9	1
2	269	400	19	9	1
2	269	390	19	9	1
2	269	380	19	9	1
2	269	370	19	9	1
2	269	360	19	9	1
2	269	350	19	9	1
2	269	340	19	9	1
2	269	330	19	9	1
2	289	330	19	9	1
2	289	340	19	9	1
2	289	350	19	9	1
2	289	360	19	9	1
2	289	370	19	9	1
2	289	380	19	9	1
2	249	310	19	9	1
2	249	320	19	9	1
2	249	330	19	9	1
2	229	320	19	9	1
2	229	330	19	9	1
2	329	310	19	9	1
2	329	320	19	9	1
2	329	330	19	9	1
2	349	330	19	9	1
2	349	320	19	9	1
