1	510	120	19	9	7
1	289	230	19	9	1
1	309	230	19	9	1
1	269	339	85	10	5
1	200	207	10	55	2
1	409	207	10	55	11
1	522	340	19	9	6
1	522	360	19	9	5
1	442	360	19	9	5
1	442	340	19	9	5
1	522	300	19	9	1
1	482	300	19	9	1
1	442	300	19	9	1
1	422	310	19	9	1
1	422	330	19	9	1
1	422	350	19	9	1
2	442	320	19	9	1
2	442	310	19	9	1
2	462	310	19	9	1
2	482	310	19	9	1
2	522	320	19	9	1
2	522	310	19	9	1
2	502	310	19	9	1
2	482	320	19	9	1
2	482	330	19	9	1
2	482	340	19	9	1
2	482	350	19	9	1
2	482	360	19	9	1
1	422	370	19	9	1
1	462	370	19	9	1
1	502	370	19	9	1
1	542	370	19	9	1
1	542	350	19	9	1
1	542	330	19	9	1
1	542	310	19	9	1
1	502	190	19	9	1
1	482	170	19	9	1
1	502	150	19	9	2
1	482	130	19	9	1
1	490	200	19	9	1
1	510	180	19	9	1
1	490	180	19	9	1
1	470	180	19	9	5
1	450	160	19	9	1
1	470	160	19	9	1
1	490	160	19	9	3
1	510	160	19	9	1
1	530	160	19	9	1
1	510	140	19	9	2
1	490	140	19	9	1
1	470	140	19	9	8
1	490	120	19	9	1
1	150	130	19	9	1
1	130	130	19	9	1
1	110	130	19	9	1
1	110	170	19	9	1
1	110	150	19	9	3
1	130	150	19	9	1
1	150	150	19	9	1
1	150	170	19	9	1
1	130	170	19	9	1
1	120	180	19	9	1
1	140	180	19	9	1
1	160	160	19	9	3
1	140	160	19	9	1
1	120	160	19	9	1
1	100	160	19	9	1
1	100	140	19	9	1
1	120	140	19	9	3
1	140	140	19	9	1
1	160	140	19	9	3
1	140	120	19	9	1
1	120	120	19	9	1
2	320	210	19	9	1
2	340	210	19	9	1
2	340	220	19	9	1
2	340	240	19	9	1
2	320	250	19	9	1
2	340	250	19	9	1
2	340	260	19	9	1
2	320	260	19	9	1
2	300	260	19	9	1
2	300	200	19	9	1
2	280	260	19	9	1
2	260	260	19	9	1
2	280	250	19	9	1
2	260	250	19	9	1
2	280	210	19	9	1
2	260	210	19	9	1
2	260	240	19	9	1
2	260	220	19	9	1
2	340	200	19	9	1
2	320	200	19	9	1
2	280	200	19	9	1
2	260	200	19	9	1
1	120	360	19	9	1
1	140	360	19	9	1
1	160	320	19	9	2
1	160	340	19	9	1
1	140	340	19	9	1
1	120	340	19	9	1
1	100	340	19	9	1
1	100	320	19	9	1
1	120	320	19	9	1
1	140	320	19	9	1
1	140	300	19	9	2
1	120	300	19	9	1
1	129	290	19	9	3
1	109	310	19	9	1
1	129	310	19	9	1
1	149	310	19	9	2
1	169	330	19	9	2
1	149	350	19	9	1
1	149	330	19	9	1
1	129	330	19	9	1
1	109	330	19	9	1
1	89	330	19	9	1
1	109	350	19	9	1
1	129	350	19	9	1
1	129	370	19	9	3
1	269	120	80	9	6
1	460	230	19	9	4
1	140	230	19	9	11
1	470	200	19	9	12
2	289	380	19	9	1
1	269	380	19	9	1
1	229	460	19	9	1
1	229	450	19	9	1
1	229	440	19	9	1
1	249	410	19	9	1
1	269	410	19	9	1
1	289	410	19	9	1
1	329	400	63	22	1
1	137	400	63	22	1
