1	368	436	31	31	1
1	400	436	31	31	1
1	432	436	31	31	1
1	432	404	31	31	1
1	400	404	31	31	1
1	368	404	31	31	1
1	304	404	31	31	1
1	272	404	31	31	1
1	240	404	31	31	1
1	208	404	31	31	1
1	208	372	31	31	1
1	240	372	31	31	1
1	272	372	31	31	1
1	304	372	31	31	1
1	368	372	31	31	1
1	400	372	31	31	1
1	432	372	31	31	1
1	336	372	31	31	1
1	336	404	31	31	1
1	336	436	31	31	1
1	272	436	31	31	1
1	240	436	31	31	1
1	208	436	31	31	1
1	176	436	31	31	1
1	144	436	31	31	1
1	112	436	31	31	1
1	80	436	31	31	1
1	48	436	31	31	1
1	16	436	31	31	1
1	464	436	31	31	1
1	496	436	31	31	1
1	528	436	31	31	1
1	560	436	31	31	1
1	592	436	31	31	1
1	592	404	31	31	1
1	560	404	31	31	1
1	528	404	31	31	1
1	496	404	31	31	1
1	464	404	31	31	1
1	464	372	31	31	1
1	496	372	31	31	1
1	528	372	31	31	1
1	560	372	31	31	1
1	592	372	31	31	1
1	592	340	31	31	1
1	560	340	31	31	1
1	528	340	31	31	1
1	496	340	31	31	1
1	464	340	31	31	1
1	432	340	31	31	1
1	400	340	31	31	1
1	368	340	31	31	1
1	336	340	31	31	1
1	304	340	31	31	1
1	272	340	31	31	1
1	240	340	31	31	1
1	208	340	31	31	1
1	176	340	31	31	1
1	144	340	31	31	1
1	112	340	31	31	1
1	80	340	31	31	1
1	48	340	31	31	1
1	16	340	31	31	1
1	16	372	31	31	1
1	48	372	31	31	1
1	80	372	31	31	1
1	112	372	31	31	1
1	144	372	31	31	1
1	176	372	31	31	1
1	176	404	31	31	1
1	144	404	31	31	1
1	112	404	31	31	1
1	80	404	31	31	1
1	48	404	31	31	1
1	16	404	31	31	1
1	16	308	31	31	1
1	16	276	31	31	1
1	16	244	31	31	1
1	16	212	31	31	1
1	16	180	31	31	1
1	16	148	31	31	1
1	592	116	31	31	1
1	592	84	31	31	1
1	496	52	31	31	1
1	464	52	31	31	1
1	432	52	31	31	1
1	400	52	31	31	1
1	368	52	31	31	1
1	240	52	31	31	1
1	208	52	31	31	1
1	176	52	31	31	1
1	144	52	31	31	1
1	112	52	31	31	1
1	16	84	31	31	1
1	16	116	31	31	1
1	48	84	31	31	1
1	80	84	31	31	1
1	112	84	31	31	1
1	144	84	31	31	1
1	176	84	31	31	1
1	208	84	31	31	1
1	240	84	31	31	1
1	272	84	31	31	1
1	304	84	31	31	1
1	336	84	31	31	1
1	368	84	31	31	1
1	400	84	31	31	1
1	432	84	31	31	1
1	464	84	31	31	1
1	496	84	31	31	1
1	528	84	31	31	1
1	560	84	31	31	1
1	560	116	31	31	1
1	528	116	31	31	1
1	496	116	31	31	1
1	464	116	31	31	1
1	432	116	31	31	1
1	400	116	31	31	1
1	368	116	31	31	1
1	336	116	31	31	1
1	304	116	31	31	1
1	272	116	31	31	1
1	240	116	31	31	1
1	208	116	31	31	1
1	176	116	31	31	1
1	144	116	31	31	1
1	112	116	31	31	1
1	80	116	31	31	1
1	48	116	31	31	1
1	48	148	31	31	1
1	80	148	31	31	1
1	112	148	31	31	1
1	144	148	31	31	1
1	176	148	31	31	1
1	208	148	31	31	1
1	240	148	31	31	1
1	272	148	31	31	1
1	304	148	31	31	1
1	336	148	31	31	1
1	368	148	31	31	1
1	400	148	31	31	1
1	432	148	31	31	1
1	464	148	31	31	1
1	496	148	31	31	1
1	528	148	31	31	1
1	560	148	31	31	1
1	592	148	31	31	1
1	592	180	31	31	1
1	560	180	31	31	1
1	528	180	31	31	1
1	496	180	31	31	1
1	464	180	31	31	1
1	432	180	31	31	1
1	400	180	31	31	1
1	368	180	31	31	1
1	336	180	31	31	1
1	304	180	31	31	1
1	272	180	31	31	1
1	240	180	31	31	1
1	208	180	31	31	1
1	176	180	31	31	1
1	144	180	31	31	1
1	112	180	31	31	1
1	80	180	31	31	1
1	48	180	31	31	1
1	48	212	31	31	1
1	80	212	31	31	1
1	112	212	31	31	1
1	144	212	31	31	1
1	176	212	31	31	1
1	208	212	31	31	1
1	240	212	31	31	1
1	272	212	31	31	1
1	304	212	31	31	1
1	336	212	31	31	1
1	368	212	31	31	1
1	400	212	31	31	1
1	432	212	31	31	1
1	464	212	31	31	1
1	496	212	31	31	1
1	528	212	31	31	1
1	560	212	31	31	1
1	592	212	31	31	1
1	592	244	31	31	1
1	560	244	31	31	1
1	528	244	31	31	1
1	496	244	31	31	1
1	464	244	31	31	1
1	432	244	31	31	1
1	400	244	31	31	1
1	368	244	31	31	1
1	336	244	31	31	1
1	304	244	31	31	1
1	272	244	31	31	1
1	240	244	31	31	1
1	208	244	31	31	1
1	176	244	31	31	1
1	144	244	31	31	1
1	112	244	31	31	1
1	80	244	31	31	1
1	48	244	31	31	1
1	48	276	31	31	1
1	80	276	31	31	1
1	112	276	31	31	1
1	144	276	31	31	1
1	176	276	31	31	1
1	208	276	31	31	1
1	240	276	31	31	1
1	272	276	31	31	1
1	304	276	31	31	1
1	336	276	31	31	1
1	368	276	31	31	1
1	400	276	31	31	1
1	432	276	31	31	1
1	464	276	31	31	1
1	496	276	31	31	1
1	528	276	31	31	1
1	560	276	31	31	1
1	592	276	31	31	1
1	592	308	31	31	1
1	560	308	31	31	1
1	528	308	31	31	1
1	496	308	31	31	1
1	464	308	31	31	1
1	432	308	31	31	1
1	400	308	31	31	1
1	368	308	31	31	1
1	336	308	31	31	1
1	304	308	31	31	1
1	272	308	31	31	1
1	240	308	31	31	1
1	208	308	31	31	1
1	176	308	31	31	1
1	144	308	31	31	1
1	112	308	31	31	1
1	80	308	31	31	1
1	48	308	31	31	1
